20,10
####--##############
#--####------------#
#------------------#
#------------------#
#------------------#
#------------------#
#------------------#
#------------------#
#------------------#
####################
